W t t t t t t t t t t t t t t t t t t t t t t t t
W t t t t t t t t t t t t t t t t t t t t t t t t
W t t t t t t t t t t t t t t t t t t t t t t t t
W t t t t t t t t t t t t t t t t t t t t t t t t 
W t t t t t t t t t t t t t t t t t t t t t t t t
W W t t t t t t t t t t t t t t t t t t t t t t t
W W t t t t t t t t t t t t t t t t t t t t t t t
W W t t t t t t t t t t t t t t t t t t t t t t t
W W W t t t t t t t t t t t t t t t t t t t t t t
W W W t t t t t t t t t t t t t t t t t t t t t t 
W W W t t t t t t t t t t t t t t t t t t t t t t
W W W t t t t t t t t t t t t t t t t t t t t t t
W W W W t t t t t t t t t t t t t t t t t t t t t
W W W W t t t t t t t t t t t t t t t t t t t t t
W W W W W W t t t t t t t t t t t t t t t t t t t
W W W W W W t t t t t t t t t t t t t t t t t t t
W W W W W W W W t t t t t t t t t t t t t t t t t
W W W W W W W W W W W t t t t t t t t t t t t t t
W W W W W W W W W W W W W W t t t t t t t t t t t
W W W W W W W W W W W W W W W W W W W W W W W W W