W W W W W W W W W W W W W W W W W W W W W W W W W
W W W W W W W W W W W W W W W W W W W W W W W W W 
W W H H H H H H H H H H H H H H H H H H H H H W W 
W W H H H H H H H H H H H H H H H H H H H H H W W
W W H H H H H H H H H H H H H H H H H H H H H W W
W W H H H H H H H H H H H H H H H H H H H H H W W
W W H H H H H H H H H H H H H H H H H H H H H W W
W W H H H H H H H H H H H H H H H H H H H H H W W
W W H H H H H H H H H H H H H H H H H H H H H W W
W W H H H H H H H H H H H H H H H H H H H H H W W
W W H H H H H H H H H H H H H H H H H H H H H W W
W W H H H H H H H H H H H H H H H H H H H H H W W
W W H H H H H H H H H H H H H H H H H H H H H W W
W W H H H H H H H H H H H H H H H H H H H H H W W
W W H H H H H H H H H H H H H H H H H H H H H W W
W W H H H H H H H H H H H H H H H H H H H H H W W
W W H H H H H H H H H H H H H H H H H H H H H W W
W W H H H H H H H H H H H H H H H H H H H H H W W
W W W W W W W W W W W W W W W W W W W W W W W W W
W W W W W W W W W W W W W W W W W W W W W W W W W
