J J J J I I I I I I I I I I I I I I I I I I I I I
J J J J I I I I I I I I I I I I I I I I I I I I I
J J J J I I I I I I I I I I I I I I I I I I I I I
J J J J I I I I I I I I I I I I I I I I I I I I I
J J J J I I I I I I I I I I I I I I I I I I I I I
J J J J I I I I I I I I I I I I I I I I I I I I I
J J J J I I I I I I I I I I I I I I I I I I I I I
J J J J I I I I I I I I I I I I I I I I I I I I I
J J J J I I I I I I I I I I I I I I I I I I I I I
J J J J I I I I I I I I I I I I I I I I I I I I I
J J J J I I I I I I I I I I I I I I I I I I I I I
J J J J I I I I I I I I I I I I I I I I I I I I I
J J J J I I I I I I I I I I I I I I I I I I I I I
J J J J I I I I I I I I I I I I I I I I I I I I I
L J J J I I I I I I I I I I I I I I I I I I I I I 
L K K K K I I I I I I I I I I I I I I I I I I I I
L K K K K J J J J J J J J J J J J J J J J J J J J
L K K K K J J J J J J J J J J J J J J J J J J J J
L K K K K J J J J J J J J J J J J J J J J J J J J 
B B B B B B J J J J J J J J J J J J J J J J J J J 
